#####
#.0.#
#.#.#
#...#
#####
